# Classes & Structs
Display	KEYWORD1
DisplaySpec	KEYWORD1
LayoutConfig	KEYWORD1
Palette	KEYWORD1
Renderer	KEYWORD1
Renderable	KEYWORD1
RenderableContext	KEYWORD1
TypedRenderable	KEYWORD1
Effect	KEYWORD1
Overlay	KEYWORD1
Transition	KEYWORD1
BaseRenderableFactory	KEYWORD1
RenderableFactory	KEYWORD1
Mirror	KEYWORD1
RenderableType	KEYWORD1
RenderableOperation	KEYWORD1
TypeId	KEYWORD1

# Effect Classes
GradientEffect	KEYWORD1
NoiseEffect	KEYWORD1
NoEffect	KEYWORD1
SlideEffect	KEYWORD1
SwirlEffect	KEYWORD1
GradientEffectFactory	KEYWORD1
NoiseEffectFactory	KEYWORD1
NoEffectFactory	KEYWORD1
SlideEffectFactory	KEYWORD1
SwirlEffectFactory	KEYWORD1

# Overlay Classes
ChaseOverlay	KEYWORD1
DashOverlay	KEYWORD1
MatrixOverlay	KEYWORD1
MoireOverlay	KEYWORD1
NoOverlay	KEYWORD1
SparkleOverlay	KEYWORD1
WaveOverlay	KEYWORD1
ChaseOverlayFactory	KEYWORD1
DashOverlayFactory	KEYWORD1
MatrixOverlayFactory	KEYWORD1
MoireOverlayFactory	KEYWORD1
NoOverlayFactory	KEYWORD1
SparkleOverlayFactory	KEYWORD1
WaveOverlayFactory	KEYWORD1

# Transition Classes
FadeTransition	KEYWORD1
SlideTransition	KEYWORD1
NoTransition	KEYWORD1
FadeTransitionFactory	KEYWORD1
SlideTransitionFactory	KEYWORD1
NoTransitionFactory	KEYWORD1

# Methods
loop	KEYWORD2
render	KEYWORD2
changeEffect	KEYWORD2
nbLeds	KEYWORD2
maxSegmentSize	KEYWORD2
nbSegments	KEYWORD2
segmentSize	KEYWORD2
mapLeds	KEYWORD2
layoutName	KEYWORD2
randomEffect	KEYWORD2
randomOverlay	KEYWORD2
randomTransition	KEYWORD2
params	KEYWORD2
getMirrorName	KEYWORD2
getMirrorSize	KEYWORD2
applyMirror	KEYWORD2
mixOperation	KEYWORD2
noMirrors	KEYWORD2
undividedMirrors	KEYWORD2
unrepeatedMirrors	KEYWORD2
allMirrors	KEYWORD2
create	KEYWORD2
name	KEYWORD2
is	KEYWORD2
createRenderable	KEYWORD2
fillArray	KEYWORD2
beforeFrame	KEYWORD2
afterFrame	KEYWORD2
renderableOperations	KEYWORD2
renderableOperation	KEYWORD2
param	KEYWORD2
multiply	KEYWORD2
screen	KEYWORD2
invert	KEYWORD2
mix	KEYWORD2
freeMemory	KEYWORD2
id	KEYWORD2
addEntropy	KEYWORD2
pickRandomWeightedItem	KEYWORD2
just	KEYWORD2
declareParams	KEYWORD2
fillArrayInternal	KEYWORD2

# Literals & Enums
NONE	LITERAL1
REVERSE	LITERAL1
CENTRE	LITERAL1
EDGE	LITERAL1
REPEAT	LITERAL1
REPEAT_REVERSE	LITERAL1
OVERLAY_REPEAT_2	LITERAL1
OVERLAY_REPEAT_3	LITERAL1
OVERLAY_REPEAT_4	LITERAL1
OVERLAY_REPEAT_5	LITERAL1
OVERLAY_REPEAT_6	LITERAL1
OVERLAY_REVERSE	LITERAL1
OVERLAY_REPEAT_2_REVERSE	LITERAL1
OVERLAY_REPEAT_3_REVERSE	LITERAL1
OVERLAY_REPEAT_4_REVERSE	LITERAL1
OVERLAY_REPEAT_5_REVERSE	LITERAL1
OVERLAY_REPEAT_6_REVERSE	LITERAL1
EFFECT	LITERAL1
OVERLAY	LITERAL1
TRANSITION	LITERAL1
OVERLAY_SOURCE	LITERAL1
OVERLAY_SCREEN	LITERAL1
OVERLAY_MULTIPLY	LITERAL1
OVERLAY_INVERT	LITERAL1
RAINBOW_PALETTE	LITERAL1
NO_PALETTE	LITERAL1
PALETTES	LITERAL1